
R 1280 720
NO ./textures/north.xpm
SO ./textures/south.xpm
WE ./textures/west.xpm
EA ./textures/east.xpm
S ./textures/sprite.xpm
F 101,67,33
C 172,253,255




11111111111111111111
10000000000000000001
12002002002002002001
12002002002002002001
12002002002002002001
12002002002002002001
12222220000002222221
12222220001002222221
12222220000002222221
1222222000S002222221
11111111111111111111
